################################################################################
################################################################################
################################################################################
################################################################################
################################################################################
################################################################################
################################################################################
############################       H<        ###################################
############################                 ###################################
###################################  ###########################################
############################                 ###################################
############################                 ###################################
############################                 ###################################
############################                 ###################################
############################                 ###################################
############################   t         t   ###################################
############################                 ###################################
################################################################################
################################################################################
################################################################################
################################################################################
################################################################################
################################################################################
################################################################################