################################################################################
################################################################################
################################################################################
################################################################################
################################################################################
################################################################################
################################################################################
################################################################################
############    C       w    ### ### ### ### ### ### ###########################
############                 ### ### ### ### ### ### ###########################
############                 ### ### ### ### ### ### ###########################
############H                 '       '       '                      <##########
############                      '       '       '                  <##########
############                 ### ### ### ### ### ### ###########################
############                 ### ### ### ### ### ### ###########################
############    S       h    ###1###2###3### ### ### ###########################
################################################################################
################################################################################
################################################################################
################################################################################
################################################################################
################################################################################
################################################################################
################################################################################
