################################################################################
################################################################################
################################################################################
################################################################################
################################################################################
################################################################################
################################################################################
################################################################################
############    C       w    ### ### ### ### ### ### ###########################
############                 ### ### ### ### ### ### ###########################
############                 ###/###+###+###+###+###+###########################
############                  '   '   '       '   '    '#             ##########
############H                                           u            <##########
############                  '   '   '   '   '   '    '#             ##########
############                 ###x###y###z###+###+###+###########################
############                 ### ### ### ### ### ### ###########################
############    S       h    ###1###2###3### ### ### ###########################
################################################################################
################################################################################
################################################################################
################################################################################
################################################################################
################################################################################
################################################################################
################################################################################
