################################################################################
################################################################################
################################################################################
################################################################################
################################################################################
################################################################################
################################################################################
##############################v  #  <  #########################################
##############################v  +     +  v#####################################
##################################     #########################################
##############################           #######################################
#############################   #      #  ######################################
############################        R      #####################################
############################                 ###################################
############################    #      #   #####################################
##############################              ####################################
###############################          #######################################
##################################     #########################################
##################################  H  #########################################
################################################################################
################################################################################
################################################################################
################################################################################
################################################################################