################################################################################
################################################################################
#                                                                              #
#                                    AA                                        #
#                                 AAAAAA                                       #
#          ~~                    AAAAAA    A                                   #
#        ~~~~                   AAAAA    A AA                                  #
#      ~~~~~~                     AA      AA                                   #
#     ~~~~~                            A   A                                   #
#     ~~~~~~                             A                                     #
#      ~~~~                        AAAA                                        #
#                                    AA                                        #
#                       A                           A                          #
#                   AA AAAA                         AAA        B               #
#                       AA A                   ~~    AAA      BB               #
#                        A                  ~~~~~~    AA      B                #
#                                           ~~ ~~                              #
#      AA                        AA A                                          #
#     AAA                         AAA  A                                       #
#                                  AAA    A                                    #
#                                   AA                                         #
#                                                                              #
################################################################################
################################################################################